000000XXXXX00000XXX00XXXX000XXXX000X0XXX
00000XXXXXXX000XX00000XX000XXXXX0000XXXX
0000000XXXX00000XX000XXX00000XXXXX0000XX
000000XXX0000000000000000000000000000000
0000000000000000000000000000000000000000
0000000000000000000000000110000000000000
0000000000000000000000001221010000000000
000000~~~0000000000000012542131000000000
~~~~~~~~~~~~~~~0000000001776863100000000
~~~~~~000~~~~~~0000000013688842100000000
00000000000000~~~~~~00012579731000000000
00000000000000~~~~~~00001488843100000000
0000000000000000000~~0001264453100000000
0000000000000000000~~00001311211VV000000
0000000000000000000~~0000010010000000000
0000000000000000000~~000000000000VVVV000
0000000000000000000~~000000000VVVVVVV000
00000000000000000000~~000000000000000000
000000000000000000000~~00000000000000000
0000000000000000000000~~0000000000000000
0000000000000000000000~~~000000000000000
00000000000000000000000~~~~~~~~000000000
00000000000000000000000~~~~~~~~000000000
00000000000000000000000000000~~~~~~~0000
X0000000000000000000000000000000~~~~~000
XXX00000000000000000000000000000000~~000
XXX00000000000000000000000000000000~~000
XXXX00000000000000000000000000000000~~XX
XXXX00000000000000000000000000000000~~XX
XXX0000000000VVV0000000000000000000~~~00
XX00000000000VVV0000000000000000000~~000
0000000000000000000000000000000000~~0000
0000000000000000000000000000000000~~0000
0000000000000000000000000000000000~~0000
0000000000000000000000000000000000~~0000
00000000000000000000000000000000000~~000
00000000000000000000000000000000000~~000
00000000000000000000000000000000000~~000
0000000000000000000000000000000000000000
0000000000000000000000000000000000000000