0000000000000000000000000000000000000000
XXXXXXXXXXXXXXXX00XXXXXXXXXXXXXXXXXXXXXX
XXXXXXXXXXXXXXXX00XXXXXXXXXXXXXXXXXXXXXX
XXXXXXXXXXXXXXXX00XXXXXXXXXXXXXXXXXXXXXX
XXXXXXXXXXXXXXXX00XXXXXXXXXXXXXXXXXXXXXX
XXXXXXXXXXXXXXXX00XXXXXXXXXXXXXXXXXXXXXX
XXXXXXXXXXXXXX0000XXXXXXXXXXXXXXXXXXXXXX
XXXXXXXXXXXXXX0099XXXXXXXXXXXXXXXXXXXXXX
XXXXXXXXXXXXXX0000XXXXXXXXXXXXXXXXXXXXXX
XXXXXXXXXXXXXX9900XXXXXXXXXXXXXXXXXXXXXX
XXXXXXXXXXXXXXXX00XXXXXXXXXXXXXXXXXXXXXX
XXXXXXXXXXXXXXXX00XXXXXXXXXXXXXXXXXXXXXX
XXXXXXXXXXXXXXXX00XXXXXXXXXXXXXXXXXXXXXX
XXXXXXXXXXXXXXXX90XXXXXXXXXXXXXXXXXXXXXX
XXXXXXXXXXXXXXXX90XXXXXXXXXXXXXXXXXXXXXX
XXXXXXXXXXXXXXXX00XXXXXXXXXXXXXXXXXXXXXX
XXXXXXXXXXXXXXXX00XXXXXXXXXXXXXXXXXXXXXX
XXXXXXXXXXXXXXXX09XXXXXXXXXXXXXXXXXXXXXX
XXXXXXXXXXXXXXXX09XXXXXXXXXXXXXXXXXXXXXX
XXXXXXXXXXXXXXXX00XXXXXXXXXXXXXXXXXXXXXX
XXXXXXXXXXXXXXXX00XXXXXXXXXXXXXXXXXXXXXX
XXXXXXXXXXXXXXXX00XXXXXXXXXXXXXXXXXXXXXX
XXXXXXXXXXXXXXXX00XXXXXXXXXXXXXXXXXXXXXX
XXXXXXXXXXXXXXXX00XXXXXXXXXXXXXXXXXXXXXX
XXXXXXXXXXXXXXXX00XXXXXXXXXXXXXXXXXXXXXX
XXXXXXXXXXXXXXXX00XXXXXXXXXXXXXXXXXXXXXX
XXXXXXXXXXXXXXXX00XXXXXXXXXXXXXXXXXXXXXX
XXXXXXXXXXXXXXXX00XXXXXXXXXXXXXXXXXXXXXX
XXXXXXXXXXXXXXXX00XXXXXXXXXXXXXXXXXXXXXX
XXXXXXXXXXXXXXXX00XXXXXXXXXXXXXXXXXXXXXX
XXXXXXXXXXXXXXXX00XXXXXXXXXXXXXXXXXXXXXX
XXXXXXXXXXXXXXXX00XXXXXXXXXXXXXXXXXXXXXX
XXXXXXXXXXXXXXXX00XXXXXXXXXXXXXXXXXXXXXX
XXXXXXXXXXXXXXXX00XXXXXXXXXXXXXXXXXXXXXX
XXXXXXXXXXXXXXXX00XXXXXXXXXXXXXXXXXXXXXX
XXXXXXXXXXXXXXXX00XXXXXXXXXXXXXXXXXXXXXX
XXXXXXXXXXXXXXXX00XXXXXXXXXXXXXXXXXXXXXX
XXXXXXXXXXXXXXXX00XXXXXXXXXXXXXXXXXXXXXX
XXXXXXXXXXXXXXXX00XXXXXXXXXXXXXXXXXXXXXX
0000000000000000000000000000000000000000